QSSSSSSSSSSSSSSSSSSSSSSSSSSW
A-0000000200000000200000000A
A00SSSSSW0QSSSSSSW0QSSSSSS0A
A0000000A00000000A0A0000000A
A0SSSS00A00QSSW00A0RSSSSSS0A
A0000000A00A00A00A000000000A
A0000000000A00A00RSSSSSSSS0A
A0SSSSSSSS0A00A000000000000A
A0000000000A000000000000000A
A00SSSSS000A00SSSSS0S0SSSS0A
A00000000000000000000000000A
A0SSSSSSSSSSSSSSSSSSSSSSSS0A
A00000000000000000000000000A
A0A0A0A0A0QSWwwQSW0A0A0A0A0A
A0A0A0A0A0ADabcdDA0A0A0A0A0A
A2A0A0A0A0ADDDDDDA0A0A0A0A2A
A0A0A0A0A0RSSSSSSE0A0A0A0A0A
A00000000000020000000000000A
A0SSSSSSSSSSSSSSSSSSSSSSSS0A
A00000000000000000000000000A
A0SSSSSSS0S0S00S0S0SSSSSSS0A
A00000000000000000000000000A
A0QSSSSSW0QSSSSSSW0QSSSSSW0A
A0A00000A0A000000A0A00000A0A
A0A00200A0A002000A0A00200A0A
A0A00000A0A000000A0A00000A0A
A00000000000000000000000000A
RSSSSSSSSSSSSSSSSSSSSSSSSSSE